aaaaaaaaaa
kklpp njiop[,mvnzoecllvmf
      kplll
abcdd fghjj
annna nniio
aiopk aaapp
12344 99999
99808 11kdd
0---- =====
\\\mn kl;;b
adjnc aaaaa
opoip adada
iuopb ooopo
bui.0 ..o09
12345 54321
11223 44556
1.2.1 2.2.2
aabba ababa
aabbb bbbbb
bbbaa babaa
iopjk lkjio
kjgib ioppdd
      oooooo
  o  oasjmea
aaaaa aaaaa
aaaaa aaaad
aaaaa jiehd
aaaaa odmaa
fesfe ppppa
ppoow kkppo
ssssp sspss
sspss sssps
aaais siaaa
poiop opiip
aaaio asaoa
bobob bpbpb
q12op .oni.
...op ,,!wq
..aa1 o0o..
aaaa bbbbb
aaaaa bbbbc
aaabb bbbbc
aaaao bbcbb
aaaoa bcbbb
aoaao bibbu
aaaaa	zyoqa
jducf	ecoqd
jecah	dvtld
upkaq	zacah
oensx	lfxxj
nsuyr	zxgzm
jfjbb	ncaca
lbbzw	heuow
bskiz	ctiov
bihab	psfni
xeonq	wrqhj
eyzlu	vskfp
jkiya	sxkdr
wsdoj	ciwqi
uhhcz	iyaay
vptdz	bliit
kmoef	vdbti
myucv	fbpet
sadqr	mxfvv
xiikm	zawaw
sldkk	vuuuy
pmzom	byqfj
nxxws	btvyt
iijbf	qjiek
asqgz	dcyvx
gctur	vrzxp
umndj	zuhro
sjgik	jqibt
dkpql	lddoj
lwkzz	brwid
ympkp	itanf
ojwgg	fbxjg
iexvk	pjhgp
wevdq	uustr
oikko	dxytp
ckjie	npnkn
qrwtd	kgjad
vgwaf	oaxtu
lzykz	cwsjq
etjoe	oqwkd
tiblk	lesun
kfvwj	olqyf
weqvr	aybci
igybe	smirn
oqygr	uqkco
wihvo	rcfzw
miywp	eoqcu
dslun	mnffj
zziuo	exubr
vjsny	fvhbk
rzgzy	ppeop
sueia	fizmn
haaxe	nqhsu
bmiuu	gkckq
aetnh	gqgua
byugg	klmzp
mdnbs	jjezc
ivzqe	pusco
pxvis	kkfxu
nkunw	wwpmm
cdmsm	jbdej
sdpke	rbomc
zvtyw	bqrpo
qovju	nnfcl
xnvyg	cyoyb
zsynr	tpyhd
wjuvy	rbpdx
bxjyo	nvrrv
bihyv	esoxr
dootz	dushw
syfee	epqsd
gdmdp	aenjs
musvh	hqcxo
wktpx	gpdvc
puqqw	llncz
cbyqo	rxubn
tvgwk	qnxfu
hgesj	etsqc
zxkfi	jmyxn
eqceb	pimvt
vdkvt	zjcjz
jwkqc	btvgz
rlwsk	oyhpp
vdzrh	anxga
gyhhc	qfcko
ruhzo	orsqd
tuaxs	kxakg
hnjvd	ossxw
gogaf	zrymh
tncxo	ijarh
xnynn	cjrkh
okmzq	dfmjm
eiyjs	myvsa
cwjcy	aomvq
yfiso	twinc
tkxvu	wuqah
jbehy	ixtnc
hromn	hcqti
